R 500 500

NO ./textures/BRICK7.xpm
SO ./textures/BRICK8.xpm
WE ./textures/BRICK9.xpm
S ./textures/barrel.xpm
EA ./textures/BRICK10.xpm


F 0,0 ,0
C 255, 255, 255

1111111111
10022S0001
1000000001
1000000001
1000000001
1000000001
1000000001
1000000001
1000210001
1020001001
1111111111