R 600 600

NO ./textures/redbrick.xpm
SO ./textures/redbrick.xpm
WE ./textures/wood.xpm
     S    ./textures/barrel.xpm
EA ./textures/colorstone.xpm


F 255, 255, 255
C 0, 0, 0

1111111111
1000000001
1000E10001
1000001001
1111111111