R 1000 500

NO ./textures/redbrick.xpm
SO ./textures/redbrick.xpm
WE ./textures/wood.xpm
     S    ./textures/barrel.xpm
EA ./textures/colorstone.xpm


F 255, 0, 0
C 21, 195, 21

      11111111111111111111111111
    1110000000200011000000000001
      11101100000111000001000001
        100100000000000001000001
1111111110000000011100000100N001
10000111111110000111011111011111
110101      11011100000010001
110101      11011101010010001
110001      11011100000010001
10010111111110001100000010001111
1100010000000011110101111000001
1111011111110101 101111000001111
11111111 1111111 111111111111111