R 1000 500

NO ./textures/redbrick.xpm
SO ./textures/redbrick.xpm
WE ./textures/wood.xpm
     S    ./textures/barrel.xpm
EA ./textures/colorstone.xpm


F 255, 255, 255
C 255, 255, 255

1111111
1001001
1010N01
1111111