R 600 600

NO ./textures/eagle.xpm
SO ./textures/eagle.xpm
WE ./textures/eagle.xpm
S./textures/barrel.xpm
EA ./textures/eagle.xpm


F 255, 255, 255
C 255, 255, 255

1111111111
1000200001
1000010001
1020N01001
1111111111